#Train Set	Test Set
aha-compress	aha-compress
aha-mont	aha-mont
ctl-stack	ctl-stack
ctl-vector	ctl-vector
ctl-string	ctl-string
dhrystone	dhrystone
fasta	fasta
dtoa	dtoa
fir	fir
edn	edn
frac	frac
matmult_float	matmult_float
huffbench	huffbench
minver	minver
levenshtein	levenshtein
ndes	ndes
ludcmp	ludcmp
nettle-arcfour	nettle-arcfour
miniz	miniz
picojpeg	picojpeg
nbody	nbody
qurt	qurt
nettle-aes	nettle-aes
sglib_heap-arraysort	sglib_heap-arraysort
nettle-sha	nettle-sha
sglib_heap-dllist	sglib_heap-dllist
newlib-exp	newlib-exp
sglib_heap-listinsertsort	sglib_heap-listinsertsort
newlib-log	newlib-log
sglib_heap-listsort	sglib_heap-listsort
prime	prime
sglib_quick-arraybinsearch	sglib_quick-arraybinsearch
sglib_heap-arraybinsearch	sglib_heap-arraybinsearch
sglib_quick-arrayheapsort	sglib_quick-arrayheapsort
sglib_heap-arrayheapsort	sglib_heap-arrayheapsort
sglib_quick-arrayquicksort	sglib_quick-arrayquicksort
sglib_heap-arrayquicksort	sglib_heap-arrayquicksort
sglib_quick-arraysort	sglib_quick-arraysort
sglib_heap-hashtable	sglib_heap-hashtable
sglib_quick-dllist	sglib_quick-dllist
sglib_heap-queue	sglib_heap-queue
sglib_quick-hashtable	sglib_quick-hashtable
sglib_heap-rbtree	sglib_heap-rbtree
sglib_quick-rbtree	sglib_quick-rbtree
sglib_quick-listinsertsort	sglib_quick-listinsertsort
slre	slre
sglib_quick-listsort	sglib_quick-listsort
sglib_quick-queue	sglib_quick-queue
stanford	stanford
whetstone	whetstone

